6,6,6,6,6,6,6,6,6,6,6,6,6,6,6,6,6,6,6,6,6,6,6,6,6
6,6,6,6,6,6,6,6,6,6,6,6,6,6,6,6,6,6,6,6,6,6,6,6,6
6,6,0,0,0,0,0,0,0,0,0,0,0,0,0,3,0,0,0,0,0,3,3,6,6
6,6,0,0,0,0,0,0,3,0,0,0,0,0,3,0,0,0,3,0,0,0,3,6,6
6,6,0,0,0,0,0,0,0,0,0,0,0,0,0,0,0,0,0,0,0,0,0,6,6
6,6,0,0,0,0,0,3,0,0,0,0,0,0,0,0,0,0,0,0,3,0,0,6,6
6,6,0,3,0,0,0,0,0,0,0,0,3,0,0,0,0,0,3,0,0,0,3,6,6
6,6,0,0,0,0,0,3,0,0,0,0,0,0,0,0,0,0,0,0,6,6,6,6,6
6,6,6,6,0,6,6,0,0,0,0,0,0,0,0,0,3,0,0,0,6,6,6,6,6
6,6,6,6,0,6,6,0,3,0,0,0,0,0,0,3,3,3,0,0,0,0,0,6,6
6,6,6,6,0,6,6,0,0,3,0,0,0,0,0,0,0,0,0,0,6,6,6,6,6
6,6,6,6,5,6,6,0,0,0,3,0,0,0,0,0,0,4,4,4,6,6,6,6,6
6,6,6,5,5,5,6,0,3,0,0,0,0,0,0,0,0,4,6,6,6,6,6,6,6
6,6,6,5,5,5,6,0,0,0,0,0,0,0,0,0,0,4,6,5,5,5,6,6,6
6,6,6,5,5,5,6,0,0,0,0,0,0,0,0,0,0,0,5,5,5,5,6,6,6
6,6,6,6,6,6,6,0,0,0,0,0,0,0,0,0,0,4,6,5,5,5,6,6,6
6,6,0,0,0,0,0,0,3,3,0,0,0,0,0,3,0,4,6,6,6,6,6,6,6
6,6,0,4,4,4,4,4,0,0,0,0,0,0,3,0,0,4,0,0,0,0,0,6,6
6,2,4,2,2,2,2,4,4,4,3,0,0,0,3,0,4,4,4,4,4,6,6,6,6
6,2,0,2,2,2,2,2,2,4,0,0,0,0,0,4,4,2,2,2,2,2,2,2,6
6,2,0,0,0,0,0,2,2,4,3,3,5,3,4,4,2,2,2,2,2,2,2,2,6
6,2,0,3,3,3,0,2,2,4,4,0,0,0,4,2,2,2,2,2,2,2,2,2,6
6,2,0,0,0,0,2,2,2,2,4,6,6,6,4,2,2,2,2,2,2,2,2,2,6
6,2,2,2,2,2,2,2,2,2,4,6,6,6,4,2,2,2,2,2,2,2,2,2,6
6,2,2,2,2,2,2,2,2,2,2,2,2,2,2,2,2,2,2,2,2,2,2,2,6
